(If you are new to interactive fiction, you might want to type "help" before starting to play to learn the basics of this type of game.)

The shrill beep of the alarm clock wakes you up from a beautiful dream you can only vaguely remember. You barely manage to hit the button to switch the alarm off, groaning. You are extremely tired. You knew you had to pay the price when you went to bed that late yesterday evening, and you also knew that you had to get up early today because there is a lot of work to do. You still need to finish a number of things and the deadline is this evening.

Well, anyway. You will be working from home today and all you have to do is getting to your desk in your home office room and start being productive.

Coffee
A small piece of interactive fiction by Bastian Krol
Release 1 / Serial number 130101 / Inform 7 build 6G60 (I6/v6.32 lib 6/12N) SD

Bedroom (on the bed)
Your bedroom is barely big enough for the bed and a small closet. The air is a bit stuffy in here. Through a small window in the north wall you can see that it's still dark outside, which is to be expected at this early hour. The only exit is south to the living room.

>get off the bed
You get off the bed.

Bedroom
Your bedroom is barely big enough for the bed and a small closet. The air is a bit stuffy in here. Through a small window in the north wall you can see that it's still dark outside, which is to be expected at this early hour. The only exit is south to the living room.

>s
Living Room
The living room of your tiny, over-priced flat. As untidy as usual. Large windows open to the south and provide a nice view of the city (or would, if it weren't still dark outside). A door to the north leads back to the bedroom. To the west is the hallway and the kitchen is to the east.

There is a low table in front of the sofa.

On the low table is a laptop.

Crammed into one corner is an old floor lamp.

>w
Hallway
A small corridor that is west of the living room. A door to the north leads to the bathroom, the opposite door to the south leads to your home office room. The apartment entrance door is to the west.

>s
Start working now?!? You definitely need a coffee first! Otherwise you'll probably fall asleep as soon as you sit down at your desk. You'll better come here again when you are ready to work.

* * *

>w
Hallway
A small corridor that is west of the living room. A door to the north leads to the bathroom, the opposite door to the south leads to your home office room. The apartment entrance door is to the west.

>w
You can't leave your flat now, not with all the work that you need to do today.

>open door
You can't leave your flat now, not with all the work that you need to do today.

>open entrance
You can't leave your flat now, not with all the work that you need to do today.

>open apartment entrance
You can't leave your flat now, not with all the work that you need to do today.

* * *

>s
Living Room
The living room of your tiny, over-priced flat. As untidy as usual. Large windows open to the south and provide a nice view of the city (or would, if it weren't still dark outside). A door to the north leads back to the bedroom. To the west is the hallway and the kitchen is to the east.

There is a low table in front of the sofa.

On the low table is a laptop.

Crammed into one corner is an old floor lamp.

>e
Kitchen
The kitchen is very narrow, though quite long. Lined up at the left side is the fridge, the kitchen counter, the sink, the oven and a cupboard. A rather large coffee machine and a toaster nearly fill the small kitchen counter. Behind them you can see a wall outlet. A tiny kitchen table with two chairs is at the north end.

The only exit is west, to the living room.

On the kitchen table is a pack of toast (closed) (in which are ten untoasted pieces of toast).

>open cupboard
You open the cupboard, revealing a cup and a knife.

>get cup
Taken.

>put cup in machine
You put the cup into the coffee machine.

>plug machine into outlet
You plug the coffee machine into the wall outlet.

>get watertank. put it in sink. turn on tap. turn off tap. get watertank. put it into machine.
Taken.

You put the watertank into the sink.

The water starts to flow into the watertank. It is full now.

The water stops flowing.

Taken.

You put the watertank back into the coffee machine.

>push button
The coffee machine emits a short, happy beep and begins its usual cacaphony off grinding and brewing noises.
A little later, a stream of hot, black coffee flows into the cup. The crema on top just looks delicious.

>drink coffee
(the cup of coffee)
Ahh. That was badly needed.
You notice that you are a little hungry. Breakfast would be nice.

[Your score has just gone up by four points.]

>w
Living Room
The living room of your tiny, over-priced flat. As untidy as usual. Large windows open to the south and provide a nice view of the city (or would, if it weren't still dark outside). A door to the north leads back to the bedroom. To the west is the hallway and the kitchen is to the east.

There is a low table in front of the sofa.

On the low table is a laptop.

Crammed into one corner is an old floor lamp.

>w
Hallway
A small corridor that is west of the living room. A door to the north leads to the bathroom, the opposite door to the south leads to your home office room. The apartment entrance door is to the west.

>s
You think it's about time to start working? But you didn't even have breakfast. You already feel a little hungry and it will be worse soon. You will not be able to concentrate and do anything useful. Besides, starting to work now and stopping for breakfast in half an hour will only interrupt your flow. You'll better come here again when you are ready to work.

* * *

>drink coffee
(the cup of coffee)
Ahh. That was badly needed.
You notice that you are a little hungry. Breakfast would be nice.

[Your score has just gone up by four points.]

>unplug coffee machine
(from the wall outlet)
You unplug the coffee machine from the wall outlet.

>plug toaster into outlet
You plug the toaster into the wall outlet.

>get pack
Taken.

>open pack
You open the pack of toast.

>get toast
(the untoasted piece of toast)
Taken.

>put it into toaster
You put the untoasted piece of toast into the first slot of the toaster.

>push lever
You push the lever down and the coils inside the toaster start to glow.
A little while later, the lever of the toaster pops up again and so does the toast.
It has been toasted to a tasty looking light golden brown.

>wait. wait.
Time passes.

Time passes.

>get toasted toast
Taken.

>eat it
Dry toast - not exactly a treat. But you do not feel hungry anymore and if nothing else is available, this may count as breakfast.

[Your score has just gone up by two points.]

>w
Living Room
The living room of your tiny, over-priced flat. As untidy as usual. Large windows open to the south and provide a nice view of the city (or would, if it weren't still dark outside). A door to the north leads back to the bedroom. To the west is the hallway and the kitchen is to the east.

There is a low table in front of the sofa.

On the low table is a laptop.

Crammed into one corner is an old floor lamp.

* * *

>w
Hallway
A small corridor that is west of the living room. A door to the north leads to the bathroom, the opposite door to the south leads to your home office room. The apartment entrance door is to the west.

>s
Yes, you should really start working now. Um, but on the other hand, what would you want to do in the office without your laptop, anyway? No use sitting at your desk without the proper equipment. You'll better come here again when you are ready to work.

* * *

>w
Living Room
The living room of your tiny, over-priced flat. As untidy as usual. Large windows open to the south and provide a nice view of the city (or would, if it weren't still dark outside). A door to the north leads back to the bedroom. To the west is the hallway and the kitchen is to the east.

There is a low table in front of the sofa.

On the low table is a laptop.

Crammed into one corner is an old floor lamp.

>get laptop
You fetch the laptop from the table. You spend yesterday evening and a good part of the night slouching about on the sofa, watching TV without paying attention and at the same time surfing the internet. You don't even remember exactly what pages in particular you were reading, probably meaningless nonsense, as usual. You did so until the battery was sucked empty. Being too lazy to search for the power supply, you finally went to bed. If only you could remember where you put the power supply.

[Your score has just gone up by one point.]

>w
Hallway
A small corridor that is west of the living room. A door to the north leads to the bathroom, the opposite door to the south leads to your home office room. The apartment entrance door is to the west.

>s
Yes, you should really start working now. Okay, let's see. You have your laptop, that's fine. But its battery seems to be completely empty so you better search for the power supply first. No use sitting at your desk without the proper equipment. You'll better come here again when you are ready to work.

* * *

>get laptop
You fetch the laptop from the table. You spend yesterday evening and a good part of the night slouching about on the sofa, watching TV without paying attention and at the same time surfing the internet. You don't even remember exactly what pages in particular you were reading, probably meaningless nonsense, as usual. You did so until the battery was sucked empty. Being too lazy to search for the power supply, you finally went to bed. If only you could remember where you put the power supply.

[Your score has just gone up by one point.]

>n
Bedroom
Your bedroom is barely big enough for the bed and a small closet. The air is a bit stuffy in here. Through a small window in the north wall you can see that it's still dark outside, which is to be expected at this early hour. The only exit is south to the living room.

>look under bed
Under the bed you discover the power supply of your laptop that you have been missing since the day before yesterday. You knew it had to be somewhere. But somehow it looks weird.

>take power supply
(the power supply)
You crawl halfway under the bed and pull the power supply by the cable. Something is seriously wrong with it. The power cord (which is supposed to connect the unit to the wall outlet) has been ripped in two. The power plug is missing completely. Looks like the dog of your neighbour had some fun with it the last time you watched (or rather, failed to watch) after it, two days ago. It must have used the power supply as a sort of toy when you were inattentive, leaving it under the bed in the end. Luckily, the power supply unit itself and the cable that would connect to your laptop look undamaged.

[Your score has just gone up by three points.]

>s
Living Room
The living room of your tiny, over-priced flat. As untidy as usual. Large windows open to the south and provide a nice view of the city (or would, if it weren't still dark outside). A door to the north leads back to the bedroom. To the west is the hallway and the kitchen is to the east.

There is a low table in front of the sofa.

Crammed into one corner is an old floor lamp.

>w
Hallway
A small corridor that is west of the living room. A door to the north leads to the bathroom, the opposite door to the south leads to your home office room. The apartment entrance door is to the west.

>s
Yes, you should really start working now. Okay, let's see. You have your laptop and the power supply. But the power supply is still not in a usable state, and the battery of the laptop seems to be completely empty. You need to do something about the broken power supply and the missing power plug before actually starting to work. You'll better come here again when you have taken care of this.

* * *

>s
Living Room
The living room of your tiny, over-priced flat. As untidy as usual. Large windows open to the south and provide a nice view of the city (or would, if it weren't still dark outside). A door to the north leads back to the bedroom. To the west is the hallway and the kitchen is to the east.

There is a low table in front of the sofa.

Crammed into one corner is an old floor lamp.

>e
Kitchen
The kitchen is very narrow, though quite long. Lined up at the left side is the fridge, the kitchen counter, the sink, the oven and a cupboard. A rather large coffee machine and a toaster nearly fill the small kitchen counter. Behind them you can see a wall outlet. A tiny kitchen table with two chairs is at the north end.

The only exit is west, to the living room.

>get knife
Taken.

>w
Living Room
The living room of your tiny, over-priced flat. As untidy as usual. Large windows open to the south and provide a nice view of the city (or would, if it weren't still dark outside). A door to the north leads back to the bedroom. To the west is the hallway and the kitchen is to the east.

There is a low table in front of the sofa.

Crammed into one corner is an old floor lamp.

>cut power cord
(with the knife)
You cut of the power plug from the power cord of the old lamp.

[Your score has just gone up by two points.]

>get plug
Taken.

>connect plug to supply
(the power supply)
You fumble and and twiddle with the stranded wires but finally manage to connect each of the wires from the power plug to the corresponding wire of the broken power cord of the power supply. Lacking proper tools for the job you just twist them together but it seems to hold well enough for now, if you handle it carefully. Luckily, each wire still has a bit of colored insulation so it's easy to figure out which connections need to be made.

[Your score has just gone up by one point.]

>w
Hallway
A small corridor that is west of the living room. A door to the north leads to the bathroom, the opposite door to the south leads to your home office room. The apartment entrance door is to the west.

>s
You enter your office and finally sit down at your desk, plug the power plug (that once belonged to the old floor lamp) into the wall outlet and connect the power supply to your laptop. Your improvised power cord makes gentle frizzling noises now and then but it seems to work. The first thing you do is to order a proper replacement for it online. You feel energetic and start to type away, soon completely immersed in your work.

    *** You have won ***

In that game you scored 18 out of a possible 21, in 40 turns.

Would you like to RESTART, RESTORE a saved game, QUIT or UNDO the last command?

* * *

>get plug
Taken.

>w
Hallway
A small corridor that is west of the living room. A door to the north leads to the bathroom, the opposite door to the south leads to your home office room. The apartment entrance door is to the west.

>s
Yes, you should really start working now. Okay, let's see. You have your laptop and the power supply. But the power supply is still not in a usable state, and the battery of the laptop seems to be completely empty. You need to do something about the broken power supply and the missing power plug before actually starting to work. You'll better come here again when you have taken care of this.

Hmm... now you have a power supply which misses a power plug and you have a power plug. I wonder if these two can somehow be connected.

* * *

>get plug
Taken.

>x laptop
Your laptop, with your current favorite Linux distribution on it. A new alpha version of the kernel was released yesterday and you feel the inexplicable urge to install it right away. O boy, that will be fun. Then you suddenly remember that you have some urgent work to do today. This will have to wait until later. The laptop has a power button.

>x power button
You see nothing special about the laptop's power button.

>x button
You see nothing special about the laptop's power button.

>e
Kitchen
The kitchen is very narrow, though quite long. Lined up at the left side is the fridge, the kitchen counter, the sink, the oven and a cupboard. A rather large coffee machine and a toaster nearly fill the small kitchen counter. Behind them you can see a wall outlet. A tiny kitchen table with two chairs is at the north end. The only exit is west, to the living room.

>x power button
You see nothing special about the laptop's power button.

>x button
Which do you mean, the button or the laptop's power button?

* * *

>e
Kitchen
The kitchen is very narrow, though quite long. Lined up at the left side is the fridge, the kitchen counter, the sink, the oven and a cupboard. A rather large coffee machine and a toaster nearly fill the small kitchen counter. Behind them you can see a wall outlet. A tiny kitchen table with two chairs is at the north end.

The only exit is west, to the living room.

On the kitchen table is a pack of toast (closed) (in which are ten untoasted pieces of toast).

>x toaster
A classically styled two slot chrome toaster. It has a lever on one side that can be pushed to activate the toaster. It also has a power cord with a power plug.

It is not plugged into anything.

>push lever
You push the lever down, but it immediately snaps back upwards.

>get toast
(the untoasted piece of toast)
The pack of toast isn't open.

>open pack
You open the pack of toast.

* * *

>get toast
(the untoasted piece of toast)
Taken.

>look
Kitchen
The kitchen is very narrow, though quite long. Lined up at the left side is the fridge, the kitchen counter, the sink, the oven and a cupboard. A rather large coffee machine and a toaster nearly fill the small kitchen counter. Behind them you can see a wall outlet. A tiny kitchen table with two chairs is at the north end.

The only exit is west, to the living room.

On the kitchen table is a pack of toast (in which are nine untoasted pieces of toast).

>inventory
You are carrying:
  an untoasted piece of toast

>x untoasted
You see nothing special about the untoasted piece of toast.

>eat toast
(the untoasted piece of toast)
It is not toasted yet.

>put toast in toaster
(the untoasted piece of toast in the toaster)
You put the untoasted piece of toast into the first slot of the toaster.

>push lever
You push the lever down, but it immediately snaps back upwards.

>get toast from toaster
Taken.

>eat toast
(the untoasted piece of toast)
It is not toasted yet.

>plug toaster into outlet
You plug the toaster into the wall outlet.

>push lever
You push the lever down and the coils inside the toaster start to glow.
A little while later, the lever of the toaster pops up again. If you had put a piece of toast into the toaster before activating it, you would have some tasty toasted piece of toast for breakfast by now.

>put toast in toaster
(the untoasted piece of toast in the toaster)
You put the untoasted piece of toast into the first slot of the toaster.

>put toast in toaster
(the untoasted piece of toast in the toaster)
(first taking the untoasted piece of toast)

You put the untoasted piece of toast into the second slot of the toaster.

>push lever
You push the lever down and the coils inside the toaster start to glow.
A little while later, the lever of the toaster pops up again and so does the toast.
The first toast has been toasted to a tasty looking light golden brown.
The second toast has been toasted to a tasty looking light golden brown.

>x toaster
A classically styled two slot chrome toaster. It has a lever on one side that can be pushed to activate the toaster. It also has a power cord with a power plug.

In the toaster are two toasted pieces of toast.

It is plugged into a wall outlet.

>wait. wait.
Time passes.

Time passes.

>get all from toaster
toasted piece of toast: Taken.
toasted piece of toast: Taken.

>x toasted piece of toast
You see nothing special about the toasted piece of toast.

>put it in toaster
You put the toasted piece of toast into the first slot of the toaster.

>push lever
You push the lever down and the coils inside the toaster start to glow.
A little while later, the lever of the toaster pops up again and so does the toast.
Since it had already been toasted before, it is has been charred to an inedible black, hard something now.

>push lever
You push the lever down and the coils inside the toaster start to glow.
A little while later, the lever of the toaster pops up again and so does the toast.
It had been charred black even before you put it in the toaster. It seems toasting it again did not make much of a difference - except that there is an unpleasent burnt smell in the kitchen now.

>wait. wait.
Time passes.

Time passes.

>get toast from toaster
Taken.

>x it
The charred piece of toast is still quite warm.

>eat it
No way. It has been toasted at least one time too often.

>drop it
Dropped.

>get untoasted toast
Taken.

>x table
On the kitchen table is a pack of toast (in which are seven untoasted pieces of toast).

>put untoasted toast in toaster
You put the untoasted piece of toast into the first slot of the toaster.

>push lever
You push the lever down and the coils inside the toaster start to glow.
A little while later, the lever of the toaster pops up again and so does the toast.
It has been toasted to a tasty looking light golden brown.

* * *

>wait. wait.
Time passes.

Time passes.

>get toasted piece of toast
Taken.

>x it
The toasted piece of toast is still quite warm.

>eat it
Dry toast - not exactly a treat. But you do not feel hungry anymore and if nothing else is available, this may count as breakfast.

[Your score has just gone up by two points.]

>get toast from pack
Taken.

>put it in toaster
You put the untoasted piece of toast into the first slot of the toaster.

>push lever
You push the lever down and the coils inside the toaster start to glow.
A little while later, the lever of the toaster pops up again and so does the toast.
It has been toasted to a tasty looking light golden brown.

* * *

>get toast from toaster
You grab the toast but it is still too hot to handle and you drop it accidentally to the flloor. Considering how long it has been since you last cleaned your kitchen floor, you decide that you would rather not eat this piece of toast. You throw it away immediately.

>eat toast
(the toasted piece of toast)
You're not really hungry anymore but you nibble the dry toast nonetheless.

>l
Kitchen
The kitchen is very narrow, though quite long. Lined up at the left side is the fridge, the kitchen counter, the sink, the oven and a cupboard. A rather large coffee machine and a toaster nearly fill the small kitchen counter. Behind them you can see a wall outlet. A tiny kitchen table with two chairs is at the north end.

The only exit is west, to the living room.

On the kitchen table is a pack of toast (in which are six untoasted pieces of toast).

You can also see a charred piece of toast here.

>i
You are carrying nothing.

>get three untoasted from pack
untoasted piece of toast: Taken.
untoasted piece of toast: Taken.
untoasted piece of toast: Taken.

>put untoasted into toaster
You put the untoasted piece of toast into the first slot of the toaster.

>put untoasted into toaster
You put the untoasted piece of toast into the second slot of the toaster.

>put untoasted into toaster
There are already two pieces of toast in the toaster. Another one would not fit into it.

>x toaster
A classically styled two slot chrome toaster. It has a lever on one side that can be pushed to activate the toaster. It also has a power cord with a power plug.

In the toaster are two untoasted pieces of toast.

It is plugged into a wall outlet.

>i
You are carrying:
  an untoasted piece of toast

* * *

>x it
The toasted piece of toast is still quite warm.

>put toast on toast
(the toasted piece of toast on the toasted piece of toast)
That would not be very tasty.

>open cupboard
You open the cupboard, revealing a cup and a knife.

>put cup on toast
(the toasted piece of toast)
That would not be very tasty.

>put knife on toast
(the toasted piece of toast)
That would not be very tasty.

>open fridge
You open the fridge, revealing a pack of cheese.

>put pack of toast on toast
(the toasted piece of toast)
That would not be very tasty.

>put pack of cheese on toast
(the toasted piece of toast)
That would not be very tasty.

>take slice
The pack of cheese isn't open.

>open pack of cheese
You open the pack of cheese.

>take slice
Taken.

>put slice on toast
(the toasted piece of toast)
You put the slice of cheese on the toasted piece of toast.

>i
You are carrying:
  a toasted piece of toast
    a slice of cheese
  a toasted piece of toast

>x toast
(the toasted piece of toast)
You see nothing special about the toasted piece of toast.

>eat toast
(the toasted piece of toast)
Toast with cheese for breakfast, that's not too bad. You do not feel hungry anymore.

[Your score has just gone up by three points.]

* * *

>push lever
You push the lever down and the coils inside the toaster start to glow.
A little while later, the lever of the toaster pops up again and so does the toast.
The first toast has been toasted to a tasty looking light golden brown.
The second toast has been toasted to a tasty looking light golden brown.

>x toasted
The toasted piece of toast seems to be pretty hot.

>g
The toasted piece of toast seems to be pretty hot.

>g
The toasted piece of toast is still quite warm.

>g
The toasted piece of toast is still quite warm.

>g
You see nothing special about the toasted piece of toast.

* * *

>push lever
You push the lever down and the coils inside the toaster start to glow.
A little while later, the lever of the toaster pops up again and so does the toast.
The first toast has been toasted to a tasty looking light golden brown.
The second toast has been toasted to a tasty looking light golden brown.

>get toasted
You grab the toast but it is still too hot to handle and you drop it accidentally to the flloor. Considering how long it has been since you last cleaned your kitchen floor, you decide that you would rather not eat this piece of toast. You throw it away immediately.

>undo
Kitchen
[Previous turn undone.]

>wait
Time passes.

>get toasted
You grab the toast but it is still too hot to handle and you drop it accidentally to the flloor. Considering how long it has been since you last cleaned your kitchen floor, you decide that you would rather not eat this piece of toast. You throw it away immediately.

* * *

>undo
Kitchen
[Previous turn undone.]

>undo
Kitchen
[Previous turn undone.]

* * *

>wait
Time passes.

>wait
Time passes.

>get toasted
Taken.

>x it
The toasted piece of toast is still quite warm.

* * *

>s
Living Room
The living room of your tiny, over-priced flat. As untidy as usual. Large windows open to the south and provide a nice view of the city (or would, if it weren't still dark outside). A door to the north leads back to the bedroom. To the west is the hallway and the kitchen is to the east.

There is a low table in front of the sofa.

On the low table is a laptop.

Crammed into one corner is an old floor lamp.

>get laptop
You fetch the laptop from the table. You spend yesterday evening and a good part of the night slouching about on the sofa, watching TV without paying attention and at the same time surfing the internet. You don't even remember exactly what pages in particular you were reading, probably meaningless nonsense, as usual. You did so until the battery was sucked empty. Being too lazy to search for the power supply, you finally went to bed. If only you could remember where you put the power supply.

[Your score has just gone up by one point.]

>e
Kitchen
The kitchen is very narrow, though quite long. Lined up at the left side is the fridge, the kitchen counter, the sink, the oven and a cupboard. A rather large coffee machine and a toaster nearly fill the small kitchen counter. Behind them you can see a wall outlet. A tiny kitchen table with two chairs is at the north end.

The only exit is west, to the living room.

On the kitchen table is a pack of toast (closed) (in which are ten untoasted pieces of toast).

>eat toast
(the untoasted piece of toast)
It is not toasted yet.

>open cupboard
You open the cupboard, revealing a cup and a knife.

>get knife
Taken.

* * *

>get plug
Taken.

>n
Bedroom
Your bedroom is barely big enough for the bed and a small closet. The air is a bit stuffy in here. Through a small window in the north wall you can see that it's still dark outside, which is to be expected at this early hour. The only exit is south to the living room.

>search under bed
Under the bed you discover the power supply of your laptop that you have been missing since the day before yesterday. You knew it had to be somewhere. But somehow it looks weird.

>get power supply
(the power supply)
You crawl halfway under the bed and pull the power supply by the cable. Something is seriously wrong with it. The power cord (which is supposed to connect the unit to the wall outlet) has been ripped in two. The power plug is missing completely. Looks like the dog of your neighbour had some fun with it the last time you watched (or rather, failed to watch) after it, two days ago. It must have used the power supply as a sort of toy when you were inattentive, leaving it under the bed in the end. Luckily, the power supply unit itself and the cable that would connect to your laptop look undamaged.

[Your score has just gone up by three points.]

>tie power supply to power plug
(the power supply to the floor lamp's power plug)
You fumble and and twiddle with the stranded wires but finally manage to connect each of the wires from the power plug to the corresponding wire of the broken power cord of the power supply. Lacking proper tools for the job you just twist them together but it seems to hold well enough for now, if you handle it carefully. Luckily, each wire still has a bit of colored insulation so it's easy to figure out which connections need to be made.

[Your score has just gone up by one point.]

>s
Living Room
The living room of your tiny, over-priced flat. As untidy as usual. Large windows open to the south and provide a nice view of the city (or would, if it weren't still dark outside). A door to the north leads back to the bedroom. To the west is the hallway and the kitchen is to the east.

There is a low table in front of the sofa.

Crammed into one corner is an old floor lamp.

* * *

>get off the bed
You get off the bed.

Bedroom
Your bedroom is barely big enough for the bed and a small closet. The air is a bit stuffy in here. Through a small window in the north wall you can see that it's still dark outside, which is to be expected at this early hour. The only exit is south to the living room.

>say xyzzy
Your vision begins to blur. The electric light starts to flicker and shadows leap across the walls in a wild dance, accompanied by eerie noises. You collapse as a sharp pain manifests itself in your temples. Then, as suddenly as it has come, it is all over.

You find yourself in your office. The laptop is on your desk and you are ready to work.

   *** You have won ***

In that game you scored 0 out of a possible 21, in 2 turns.

Would you like to RESTART, RESTORE a saved game, QUIT or UNDO the last command?

>r
... and suddenly you wake up. It must have been some kind of daydream. A very vivid one, indeed, but still just a dream. You find yourself lying on your sofa in the living room and you have no idea how you got here. You realize that you still did not get into the office room. At least not in this reality.

Living Room (on the sofa)
The living room of your tiny, over-priced flat. As untidy as usual. Large windows open to the south and provide a nice view of the city (or would, if it weren't still dark outside). A door to the north leads back to the bedroom. To the west is the hallway and the kitchen is to the east.

There is a low table in front of the sofa.

On the low table is a laptop.

Crammed into one corner is an old floor lamp.

>get up
You get off the sofa.

Living Room
The living room of your tiny, over-priced flat. As untidy as usual. Large windows open to the south and provide a nice view of the city (or would, if it weren't still dark outside). A door to the north leads back to the bedroom. To the west is the hallway and the kitchen is to the east.

There is a low table in front of the sofa.

On the low table is a laptop.

Crammed into one corner is an old floor lamp.

>say xyzzy
No, rather not. To be honest, you are quite afraid of what might happen. One time is enough.

* * *

>get off bed. s.
You get off the bed.

Bedroom
Your bedroom is barely big enough for the bed and a small closet. The air is a bit stuffy in here. Through a small window in the north wall you can see that it's still dark outside, which is to be expected at this early hour. The only exit is south to the living room.

Living Room
The living room of your tiny, over-priced flat. As untidy as usual. Large windows open to the south and provide a nice view of the city (or would, if it weren't still dark outside). A door to the north leads back to the bedroom. To the west is the hallway and the kitchen is to the east.

There is a low table in front of the sofa.

On the low table is a laptop.

Crammed into one corner is an old floor lamp.

>brush teeth
You can hardly brush you teeth without a toothbrush, now can you?

>w. n.
Hallway
A small corridor that is west of the living room. A door to the north leads to the bathroom, the opposite door to the south leads to your home office room. The apartment entrance door is to the west.

Bathroom
The bathroom features a shower, a toilet and a basin. There is a cheap mirror cabinet mounted to the wall above the basin. You can't help admiring the interior design skills that must have been at work to stuff all these things into this extremely tiny room. As a result, a good amount of agility and physical fitness is needed to maneuver here. The only exit is to the south.

>brush teeth
You can hardly brush you teeth without a toothbrush, now can you?

>open mirror cabinet
You open the mirror cabinet, revealing a toothbrush and a toothpaste.

>brush teeth
(First taking the toothbrush)
Maybe you should put toothpaste on the toothbrush before.

>get all
toothpaste: Taken.

>put toothbrush in mouth
Maybe you should put toothpaste on the toothbrush before.

>put toothpaste on toothbrush
You open the toothpaste.

You put some toothpaste on the toothbrush.

>brush teeth
Now your teeth are all shiny.

(By the way, this was an optional puzzle. But it's nice to see that you care about oral hygiene. Keep up the good work.)

[Your score has just gone up by two points.]

>brush teeth
I believe your teeth are as clean as they can get.

* * *

>s
(first getting off the bed)

Living Room
The living room of your tiny, over-priced flat. As untidy as usual. Large windows open to the south and provide a nice view of the city (or would, if it weren't still dark outside). A door to the north leads back to the bedroom. To the west is the hallway and the kitchen is to the east.

There is a low table in front of the sofa.

On the low table is a laptop.

Crammed into one corner is an old floor lamp.

>e
Kitchen
The kitchen is very narrow, though quite long. Lined up at the left side is the fridge, the kitchen counter, the sink, the oven and a cupboard. A rather large coffee machine and a toaster nearly fill the small kitchen counter. Behind them you can see a wall outlet. A tiny kitchen table with two chairs is at the north end.

The only exit is west, to the living room.

On the kitchen table is a pack of toast (closed) (in which are ten untoasted pieces of toast).

>get coffee machine
That's hardly portable.

>get coffee
(the coffee machine)
That's hardly portable.

>open cupboard
You open the cupboard, revealing a cup and a knife.

>get coffee
(the coffee machine)
That's hardly portable.

>x coffee
(the coffee machine)
A quite expensive bean-to-cup coffee brewer. It is probably also capable of making all sorts of coffee specialties like Cappuccino, Espresso, Latte Macchiato, Ristretto and what not. You never got around to read that part in the manual, though. That's why you just stuck with making plain coffee with it. There is a single button on the front. It is labelled with a stylized cup of coffee. The coffee machine also has a power cord with a power plug.

The display is unlit.

It is not plugged into anything.

>x power cord
Which do you mean, the coffee machine's power cord or the toaster's power cord?

>x the coffee machine's power cord
You see nothing special about the coffee machine's power cord.

>x the coffee power cord
You see nothing special about the coffee machine's power cord.

>x the coffee cord
You see nothing special about the coffee machine's power cord.

>x the coffee power
You see nothing special about the coffee machine's power cord.

>test-fill-cup
test-fill-cup done.

>x coffee
(the cup of coffee)
The cup you usually use for your morning coffee. There is some steaming black coffee in it.

>drink coffee
(the cup of coffee)
Ahh. That was badly needed.
You notice that you are a little hungry. Breakfast would be nice.

[Your score has just gone up by four points.]

>test-fill-cup
test-fill-cup done.

>open cupboard. put coffee in cupboard. close cupboard.
That's already open.

(the cup of coffee in the cupboard)
You put the cup of coffee into the cupboard.

You close the cupboard.

>x coffee
(the coffee machine)
A quite expensive bean-to-cup coffee brewer. It is probably also capable of making all sorts of coffee specialties like Cappuccino, Espresso, Latte Macchiato, Ristretto and what not. You never got around to read that part in the manual, though. That's why you just stuck with making plain coffee with it. There is a single button on the front. It is labelled with a stylized cup of coffee. The coffee machine also has a power cord with a power plug.

The display is unlit.

It is not plugged into anything.

* * *

>s
(first getting off the bed)

Living Room
The living room of your tiny, over-priced flat. As untidy as usual. Large windows open to the south and provide a nice view of the city (or would, if it weren't still dark outside). A door to the north leads back to the bedroom. To the west is the hallway and the kitchen is to the east.

There is a low table in front of the sofa.

On the low table is a laptop.

Crammed into one corner is an old floor lamp.

>cut lamp
You have nothing to cut it with.

>cut lamp with knife
You can't see any such thing.

>e
Kitchen
The kitchen is very narrow, though quite long. Lined up at the left side is the fridge, the kitchen counter, the sink, the oven and a cupboard. A rather large coffee machine and a toaster nearly fill the small kitchen counter. Behind them you can see a wall outlet. A tiny kitchen table with two chairs is at the north end.

The only exit is west, to the living room.

On the kitchen table is a pack of toast (closed) (in which are ten untoasted pieces of toast).

* * *

>open cupboard
You open the cupboard, revealing a cup and a knife.

>get all
cup: Taken.
knife: Taken.
untoasted piece of toast: The pack of toast isn't open.
untoasted piece of toast: The pack of toast isn't open.
untoasted piece of toast: The pack of toast isn't open.
untoasted piece of toast: The pack of toast isn't open.
untoasted piece of toast: The pack of toast isn't open.
untoasted piece of toast: The pack of toast isn't open.
untoasted piece of toast: The pack of toast isn't open.
untoasted piece of toast: The pack of toast isn't open.
untoasted piece of toast: The pack of toast isn't open.
untoasted piece of toast: The pack of toast isn't open.
pack of toast: Taken.

>w
Living Room
The living room of your tiny, over-priced flat. As untidy as usual. Large windows open to the south and provide a nice view of the city (or would, if it weren't still dark outside). A door to the north leads back to the bedroom. To the west is the hallway and the kitchen is to the east.

There is a low table in front of the sofa.

On the low table is a laptop.

Crammed into one corner is an old floor lamp.

>cut lamp with toast
(the pack of toast)
You can't cut things with the pack of toast.

>cut lamp with cup
You can't cut things with the cup.

>cut lamp
(with the knife)
You cut of the power plug from the power cord of the old lamp.

[Your score has just gone up by two points.]

>undo
Living Room
[Previous turn undone.]

>cut lamp with knife
You cut of the power plug from the power cord of the old lamp.

[Your score has just gone up by two points.]

>undo
Living Room
[Previous turn undone.]

>cut power cord
(with the knife)
You cut of the power plug from the power cord of the old lamp.

[Your score has just gone up by two points.]

>undo
Living Room
[Previous turn undone.]

>cut power cord with knife
You cut of the power plug from the power cord of the old lamp.

[Your score has just gone up by two points.]

>undo
Living Room
[Previous turn undone.]

>cut sofa
(with the knife)
You slash the sofa with the knife. It doesn't seem to have much effect, though.

>cut sofa with knife
You slash the sofa with the knife. It doesn't seem to have much effect, though.

>e
Kitchen
The kitchen is very narrow, though quite long. Lined up at the left side is the fridge, the kitchen counter, the sink, the oven and a cupboard. A rather large coffee machine and a toaster nearly fill the small kitchen counter. Behind them you can see a wall outlet. A tiny kitchen table with two chairs is at the north end.

The only exit is west, to the living room.

>cut toaster
(with the knife)
But that would destroy the toaster! How would you make toast then?

>cut coffee machine
(with the knife)
But that would destroy the coffee machine! How would you make coffee then?

>cut power cord
Which do you mean, the coffee machine's power cord or the toaster's power cord?

>cut coffee machine's power cord
(with the knife)
But that would destroy the coffee machine! How would you make coffee then?

>cut toaster's power cord
(with the knife)
But that would destroy the toaster! How would you make toast then?

>open pack of toast. get toast from pack.
You open the pack of toast.

Taken.

>cut toast
(the untoasted piece of toast)
(with the knife)
That would not help much.

>cut the piece of toast with the knife
That would not help much.

>cut the toaster's power cord with the knife
But that would destroy the toaster! How would you make toast then?

>put untoasted toast in toaster
You put the untoasted piece of toast into the first slot of the toaster.

>plug toaster into wall outlet
You plug the toaster into the wall outlet.

>push lever
You push the lever down and the coils inside the toaster start to glow.
A little while later, the lever of the toaster pops up again and so does the toast.
It has been toasted to a tasty looking light golden brown.

* * *

>get toasted toast
Taken.

>cut toast with knife
(the toasted piece of toast with the knife)
No need to. You could eat it, though.

* * *

>s
(first getting off the bed)

Living Room
The living room of your tiny, over-priced flat. As untidy as usual. Large windows open to the south and provide a nice view of the city (or would, if it weren't still dark outside). A door to the north leads back to the bedroom. To the west is the hallway and the kitchen is to the east.

There is a low table in front of the sofa.

On the low table is a laptop.

Crammed into one corner is an old floor lamp.

>x lamp
A shabby old thing. You should have thrown it out of your flat ages ago but never got around to do so. Its power plug is not even connected to a wall outlet, so the only purpose it serves is to gather dust on its lamp shade. You have even tripped over the power cord a few times.

>x cord
A black power cord, ending in a standard power plug.

>x plug
The power plug is firmly connected to the floor lamp's power cord.

It is not plugged into anything.

>get plug
That seems to be a part of the floor lamp's power cord.

>get cord
That seems to be a part of the floor lamp.

>get lamp
That's fixed in place.

>e
Kitchen
The kitchen is very narrow, though quite long. Lined up at the left side is the fridge, the kitchen counter, the sink, the oven and a cupboard. A rather large coffee machine and a toaster nearly fill the small kitchen counter. Behind them you can see a wall outlet. A tiny kitchen table with two chairs is at the north end.

The only exit is west, to the living room.

On the kitchen table is a pack of toast (closed) (in which are ten untoasted pieces of toast).

* * *

>get knife
Taken.

>w
Living Room
The living room of your tiny, over-priced flat. As untidy as usual. Large windows open to the south and provide a nice view of the city (or would, if it weren't still dark outside). A door to the north leads back to the bedroom. To the west is the hallway and the kitchen is to the east.

There is a low table in front of the sofa.

On the low table is a laptop.

Crammed into one corner is an old floor lamp.

>cut lamp
(with the knife)
You cut of the power plug from the power cord of the old lamp.

[Your score has just gone up by two points.]

* * *

>undo
Living Room
[Previous turn undone.]

>cut cord
(with the knife)
You cut of the power plug from the power cord of the old lamp.

[Your score has just gone up by two points.]

>undo
Living Room
[Previous turn undone.]

>cut plug
(with the knife)
You cut of the power plug from the power cord of the old lamp.

[Your score has just gone up by two points.]

>cut plug
(with the knife)
You already cut the power plug from the power cord, you would achieve nothing by cutting it even more.

>cut cord
(with the knife)
You already cut the power plug from the power cord, you would achieve nothing by cutting it even more.

>cut lamp
(with the knife)
You already cut the power plug from the power cord, you would achieve nothing by cutting it even more.

>l
Living Room
The living room of your tiny, over-priced flat. As untidy as usual. Large windows open to the south and provide a nice view of the city (or would, if it weren't still dark outside). A door to the north leads back to the bedroom. To the west is the hallway and the kitchen is to the east.

There is a low table in front of the sofa.

On the low table is a laptop.

Crammed into one corner is an old floor lamp.

You can also see a floor lamp's power plug here.

>x lamp
A shabby old thing. You should have thrown it out of your flat ages ago but never got around to do so. Its power plug is not even connected to a wall outlet, so the only purpose it serves is to gather dust on its lamp shade. You have even tripped over the power cord a few times.

>x cord
A black power cord, ending in bare wires.

>x plug
The power plug that you have cut from the power cord of the floor lamp. The short cable that comes out of the plug ends in bare wires.

It is not plugged into anything.

>n
Bedroom
Your bedroom is barely big enough for the bed and a small closet. The air is a bit stuffy in here. Through a small window in the north wall you can see that it's still dark outside, which is to be expected at this early hour. The only exit is south to the living room.

* * *

>look under bed
Under the bed you discover the power supply of your laptop that you have been missing since the day before yesterday. You knew it had to be somewhere. But somehow it looks weird.

>get supply
You crawl halfway under the bed and pull the power supply by the cable. Something is seriously wrong with it. The power cord (which is supposed to connect the unit to the wall outlet) has been ripped in two. The power plug is missing completely. Looks like the dog of your neighbour had some fun with it the last time you watched (or rather, failed to watch) after it, two days ago. It must have used the power supply as a sort of toy when you were inattentive, leaving it under the bed in the end. Luckily, the power supply unit itself and the cable that would connect to your laptop look undamaged.

[Your score has just gone up by three points.]

>s
Living Room
The living room of your tiny, over-priced flat. As untidy as usual. Large windows open to the south and provide a nice view of the city (or would, if it weren't still dark outside). A door to the north leads back to the bedroom. To the west is the hallway and the kitchen is to the east.

There is a low table in front of the sofa.

On the low table is a laptop.

Crammed into one corner is an old floor lamp.

You can also see a floor lamp's power plug here.

>get plug
Taken.

>x supply
(the power supply)
The power supply of your laptop. Or rather, most of it. The plug for the wall outlet is missing and the power cord (which the plug should be attached to) ends in bare wires.

It is not plugged into anything.

>x plug
The power plug that you have cut from the power cord of the floor lamp. The short cable that comes out of the plug ends in bare wires.

It is not plugged into anything.

>connect plug to supply
(the power supply)
You fumble and and twiddle with the stranded wires but finally manage to connect each of the wires from the power plug to the corresponding wire of the broken power cord of the power supply. Lacking proper tools for the job you just twist them together but it seems to hold well enough for now, if you handle it carefully. Luckily, each wire still has a bit of colored insulation so it's easy to figure out which connections need to be made.

[Your score has just gone up by one point.]

>x supply
(the power supply)
The power supply of your laptop. The broken power cord has been fixed, though the fix does not look exactly like the work of a professional.

It is not plugged into anything.

>x plug
The power plug is connected to your laptop's power supply.

It is not plugged into anything.

* * *

>out
You get off the bed.

Bedroom
Your bedroom is barely big enough for the bed and a small closet. The air is a bit stuffy in here. Through a small window in the north wall you can see that it's still dark outside, which is to be expected at this early hour. The only exit is south to the living room.

>look under bed
Under the bed you discover the power supply of your laptop that you have been missing since the day before yesterday. You knew it had to be somewhere. But somehow it looks weird.

>s
Living Room
The living room of your tiny, over-priced flat. As untidy as usual. Large windows open to the south and provide a nice view of the city (or would, if it weren't still dark outside). A door to the north leads back to the bedroom. To the west is the hallway and the kitchen is to the east.

There is a low table in front of the sofa.

On the low table is a laptop.

Crammed into one corner is an old floor lamp.

>get laptop
You fetch the laptop from the table. You spend yesterday evening and a good part of the night slouching about on the sofa, watching TV without paying attention and at the same time surfing the internet. You don't even remember exactly what pages in particular you were reading, probably meaningless nonsense, as usual. You did so until the battery was sucked empty. Being too lazy to search for the power supply, you finally went to bed. At least you have found the power supply by now, even if it is still broken.

[Your score has just gone up by one point.]

* * *

>look under bed
Under the bed you discover the power supply of your laptop that you have been missing since the day before yesterday. You knew it had to be somewhere. But somehow it looks weird.

>get power supply
You crawl halfway under the bed and pull the power supply by the cable. Something is seriously wrong with it. The power cord (which is supposed to connect the unit to the wall outlet) has been ripped in two. The power plug is missing completely. Looks like the dog of your neighbour had some fun with it the last time you watched (or rather, failed to watch) after it, two days ago. It must have used the power supply as a sort of toy when you were inattentive, leaving it under the bed in the end. Luckily, the power supply unit itself and the cable that would connect to your laptop look undamaged.

[Your score has just gone up by three points.]

>s
Living Room
The living room of your tiny, over-priced flat. As untidy as usual. Large windows open to the south and provide a nice view of the city (or would, if it weren't still dark outside). A door to the north leads back to the bedroom. To the west is the hallway and the kitchen is to the east.

There is a low table in front of the sofa.

On the low table is a laptop.

Crammed into one corner is an old floor lamp.

* * *

>get laptop
You fetch the laptop from the table. You spend yesterday evening and a good part of the night slouching about on the sofa, watching TV without paying attention and at the same time surfing the internet. You don't even remember exactly what pages in particular you were reading, probably meaningless nonsense, as usual. You did so until the battery was sucked empty. Being too lazy to search for the power supply, you finally went to bed. At least you have found the power supply by now, even if it is still broken.

[Your score has just gone up by one point.]

>e
Kitchen
The kitchen is very narrow, though quite long. Lined up at the left side is the fridge, the kitchen counter, the sink, the oven and a cupboard. A rather large coffee machine and a toaster nearly fill the small kitchen counter. Behind them you can see a wall outlet. A tiny kitchen table with two chairs is at the north end.

The only exit is west, to the living room.

On the kitchen table is a pack of toast (closed) (in which are ten untoasted pieces of toast).

* * *

>w
Living Room
The living room of your tiny, over-priced flat. As untidy as usual. Large windows open to the south and provide a nice view of the city (or would, if it weren't still dark outside). A door to the north leads back to the bedroom. To the west is the hallway and the kitchen is to the east.

There is a low table in front of the sofa.

Crammed into one corner is an old floor lamp.

>cut lamp
(with the knife)
You cut of the power plug from the power cord of the old lamp.

[Your score has just gone up by two points.]

>get plug
Taken.

>e
Kitchen
The kitchen is very narrow, though quite long. Lined up at the left side is the fridge, the kitchen counter, the sink, the oven and a cupboard. A rather large coffee machine and a toaster nearly fill the small kitchen counter. Behind them you can see a wall outlet. A tiny kitchen table with two chairs is at the north end.

The only exit is west, to the living room.

On the kitchen table is a pack of toast (closed) (in which are ten untoasted pieces of toast).

>press laptop's button
Nothing happens. The laptop's battery is still empty, it seems.

>plug plug into outlet
You plug the floor lamp's power plug into the wall outlet.

>press laptop's button
Nothing happens. The laptop's battery is still empty, it seems.

>plug supply into laptop
(the power supply into the laptop)
You plug the power supply into the laptop.

>press laptop's button
Nothing happens. The laptop's battery is still empty, it seems.

>connect plug to supply
(the power supply)
You fumble and and twiddle with the stranded wires while the power plug is plugged into a wall outlet. Not your best idea today. You don't even feel the electric shock before dropping to the floor.

    *** You have died. ***

In that game you scored 6 out of a possible 21, in 18 turns.

Would you like to RESTART, RESTORE a saved game, QUIT or UNDO the last command?

>undo
Kitchen
[Previous turn undone.]

>unplug plug
(from the wall outlet)
You unplug the floor lamp's power plug from the wall outlet.

>connect plug to supply
(the power supply)
You fumble and and twiddle with the stranded wires but finally manage to connect each of the wires from the power plug to the corresponding wire of the broken power cord of the power supply. Lacking proper tools for the job you just twist them together but it seems to hold well enough for now, if you handle it carefully. Luckily, each wire still has a bit of colored insulation so it's easy to figure out which connections need to be made.

[Your score has just gone up by one point.]

>plug plug into outlet
You plug the floor lamp's power plug into the wall outlet.

>press laptop's button
The laptop boots up. You start to work but after a few minutes you realize that working standing at the kitchen counter is not very convenient. You should really take your stuff to the office room and work there. Annoyed, you switch off the laptop.

>unplug supply from laptop
(the power supply from the laptop)
You unplug the power supply from the laptop.

>press laptop's button
Nothing happens. The laptop's battery is still empty, it seems.

* * *

>plug supply into laptop
(the power supply into the laptop)
You plug the power supply into the laptop.

>unplug plug
(from the wall outlet)
You unplug the floor lamp's power plug from the wall outlet.

>press laptop's button
Nothing happens. The laptop's battery is still empty, it seems.

* * *

>w
Living Room
The living room of your tiny, over-priced flat. As untidy as usual. Large windows open to the south and provide a nice view of the city (or would, if it weren't still dark outside). A door to the north leads back to the bedroom. To the west is the hallway and the kitchen is to the east.

There is a low table in front of the sofa.

On the low table is a laptop.

Crammed into one corner is an old floor lamp.

>cut power cord
(with the knife)
You cut of the power plug from the power cord of the old lamp.

[Your score has just gone up by two points.]

* * *

>connect plug to supply
(the power supply)
You fumble and and twiddle with the stranded wires but finally manage to connect each of the wires from the power plug to the corresponding wire of the broken power cord of the power supply. Lacking proper tools for the job you just twist them together but it seems to hold well enough for now, if you handle it carefully. Luckily, each wire still has a bit of colored insulation so it's easy to figure out which connections need to be made.

[Your score has just gone up by one point.]

>get laptop
You fetch the laptop from the table. You spend yesterday evening and a good part of the night slouching about on the sofa, watching TV without paying attention and at the same time surfing the internet. You don't even remember exactly what pages in particular you were reading, probably meaningless nonsense, as usual. You did so until the battery was sucked empty. Being too lazy to search for the power supply, you finally went to bed. At least you have found the power supply by now.

[Your score has just gone up by one point.]

* * *

>out
You get off the bed.

Bedroom
Your bedroom is barely big enough for the bed and a small closet. The air is a bit stuffy in here. Through a small window in the north wall you can see that it's still dark outside, which is to be expected at this early hour. The only exit is south to the living room.

>s
Living Room
The living room of your tiny, over-priced flat. As untidy as usual. Large windows open to the south and provide a nice view of the city (or would, if it weren't still dark outside). A door to the north leads back to the bedroom. To the west is the hallway and the kitchen is to the east.

There is a low table in front of the sofa.

On the low table is a laptop.

Crammed into one corner is an old floor lamp.

* * *

>s
(first getting off the bed)

Living Room
The living room of your tiny, over-priced flat. As untidy as usual. Large windows open to the south and provide a nice view of the city (or would, if it weren't still dark outside). A door to the north leads back to the bedroom. To the west is the hallway and the kitchen is to the east.

There is a low table in front of the sofa.

On the low table is a laptop.

Crammed into one corner is an old floor lamp.

>drink cup
You can't see any such thing.

>e
Kitchen
The kitchen is very narrow, though quite long. Lined up at the left side is the fridge, the kitchen counter, the sink, the oven and a cupboard. A rather large coffee machine and a toaster nearly fill the small kitchen counter. Behind them you can see a wall outlet. A tiny kitchen table with two chairs is at the north end.

The only exit is west, to the living room.

On the kitchen table is a pack of toast (closed) (in which are ten untoasted pieces of toast).

>x counter
Framed by the fridge and the oven, it is barely big enough for the coffee machine and the toaster. You notice a wall outlet behind the coffee machine and the toaster, mounted just above the kitchen counter.

>x coffee machine
A quite expensive bean-to-cup coffee brewer. It is probably also capable of making all sorts of coffee specialties like Cappuccino, Espresso, Latte Macchiato, Ristretto and what not. You never got around to read that part in the manual, though. That's why you just stuck with making plain coffee with it. There is a single button on the front. It is labelled with a stylized cup of coffee. The coffee machine also has a power cord with a power plug.

The display is unlit.

It is not plugged into anything.

>x display
It is unlit and displays no text.

>open cupboard
You open the cupboard, revealing a cup and a knife.

* * *

>get cup
Taken.

>drink cup
You sip a bit of thin air from the empty cup.

>push button
You push the button, but nothing happens. You notice that the display is unlit. Obviously the coffee machine has no power.

>plug machine into outlet
You plug the coffee machine into the wall outlet.

>push button
The coffee machine emits a low, sad beep.

>x coffee machine
A quite expensive bean-to-cup coffee brewer. It is probably also capable of making all sorts of coffee specialties like Cappuccino, Espresso, Latte Macchiato, Ristretto and what not. You never got around to read that part in the manual, though. That's why you just stuck with making plain coffee with it. There is a single button on the front. It is labelled with a stylized cup of coffee. The coffee machine also has a power cord with a power plug.

The display reads "WATERTANK EMPTY".

It is plugged into a wall outlet.

>x display
It reads "WATERTANK EMPTY".

>get watertank
Taken.

>i
You are carrying:
  a watertank
  a cup

>x watertank
The watertank is empty.

>x sink
Above the sink is a tap. It is turned off.

>x tap
The tap is currently turned off.

>get knife. put it into sink.
Taken.

You would achieve nothing by this.

>put cup into sink
You put the cup into the sink.

>put watertank into sink
There is already the cup in the sink. The sink is too small to put both the watertank and the cup into it at the same time.

>get cup
Taken.

>put watertank into sink
You put the watertank into the sink.

>x tap
The tap is currently turned off.

>switch on tap
The water starts to flow into the watertank. It is full now.

>l
Kitchen
The kitchen is very narrow, though quite long. Lined up at the left side is the fridge, the kitchen counter, the sink, the oven and a cupboard. A rather large coffee machine and a toaster nearly fill the small kitchen counter. Behind them you can see a wall outlet. A tiny kitchen table with two chairs is at the north end.

The tap is switched on and water flows into the sink.

The only exit is west, to the living room.

On the kitchen table is a pack of toast (closed) (in which are ten untoasted pieces of toast).

>x tap
The tap is currently turned on.

>switch off tap
The water stops flowing.

>get watertank
Taken.

>x watertank
The watertank is full.

>push button
The coffee machine emits a low, sad beep.

>x coffee machine
A quite expensive bean-to-cup coffee brewer. It is probably also capable of making all sorts of coffee specialties like Cappuccino, Espresso, Latte Macchiato, Ristretto and what not. You never got around to read that part in the manual, though. That's why you just stuck with making plain coffee with it. There is a single button on the front. It is labelled with a stylized cup of coffee. The coffee machine also has a power cord with a power plug.

The display reads WATERTANK MISSING.

It is plugged into a wall outlet.

>x display
It reads WATERTANK MISSING.

>put watertank in coffee machine
You put the watertank back into the coffee machine.

>undo
Kitchen
[Previous turn undone.]

>attach watertank to coffee machine
You put the watertank back into the coffee machine.

>x coffee machine
A quite expensive bean-to-cup coffee brewer. It is probably also capable of making all sorts of coffee specialties like Cappuccino, Espresso, Latte Macchiato, Ristretto and what not. You never got around to read that part in the manual, though. That's why you just stuck with making plain coffee with it. There is a single button on the front. It is labelled with a stylized cup of coffee. The coffee machine also has a power cord with a power plug.

The display reads "READY".

It is plugged into a wall outlet.

>x display
It reads "READY".

>push button
The coffee machine emits a short, happy beep and begins its usual cacaphony off grinding and brewing noises.
A little later, a stream of hot, black coffee flows directly into the drip tray, where your cup should have been. It also spills on the kitchen counter. What a mess!

>g
The coffee machine emits a short, happy beep and begins its usual cacaphony off grinding and brewing noises.
A little later, a stream of hot, black coffee flows directly into the drip tray, where your cup should have been. It also spills on the kitchen counter. What a mess!

>drink cup
You sip a bit of thin air from the empty cup.

>put cup into machine
You put the cup into the coffee machine.

>push button
The coffee machine emits a short, happy beep and begins its usual cacaphony off grinding and brewing noises.
A little later, a stream of hot, black coffee flows into the cup. The crema on top just looks delicious.

>l
Kitchen
The kitchen is very narrow, though quite long. Lined up at the left side is the fridge, the kitchen counter, the sink, the oven and a cupboard. A rather large coffee machine and a toaster nearly fill the small kitchen counter. Behind them you can see a wall outlet. A tiny kitchen table with two chairs is at the north end.

Coffee has been spilled all over the kitchen counter, but you have no time to clean that up now.

The only exit is west, to the living room.

On the kitchen table is a pack of toast (closed) (in which are ten untoasted pieces of toast).

>x counter
Framed by the fridge and the oven, it is barely big enough for the coffee machine and the toaster. You notice a wall outlet behind the coffee machine and the toaster, mounted just above the kitchen counter. A lot of coffee has been spilled all around the coffee machine and some is dropping from the kitchen counter to the floor. However, you have no time to clean that up now.

>drink coffee
(the cup of coffee)
Ahh. That was badly needed.
You notice that you are a little hungry. Breakfast would be nice.

[Your score has just gone up by three points.]

>put cup into machine
(first taking the cup)

You put the cup into the coffee machine.

>push button
The coffee machine emits a short, happy beep and begins its usual cacaphony off grinding and brewing noises.
A little later, a stream of hot, black coffee flows into the cup. The crema on top just looks delicious.

>get cup
Taken.

>turn on tap
The water starts to flow into the sink.

>put cup into sink
You put the cup into the sink.
The water from the tap fills the cup and replaces the coffee that was in it.

* * *

>get cup
Taken.

>put cup into sink
You put the cup into the sink.

>turn on tap
The water starts to flow into the cup, replacing the coffee in it. It is full of water now.

* * *

>turn on tap
The water starts to flow into the sink.

>put watertank into sink
You put the watertank into the sink.
The water from the tap fills the watertank.

>get watertank
Taken.

>put cup into sink
You put the cup into the sink.
The water from the tap fills the cup.

>get cup
Taken.

>turn off tap
The water stops flowing.

>x watertank
The watertank is full.

>x cup
The cup you usually use for your morning coffee. There is some water in it.

* * *

>get cup
Taken.

>empty coffee machine into sink
You cannot empty the coffee machine into the sink.

>empty cup into table
You cannot empty the cup into the kitchen table.

>empty cup into coffee machine
But the cup is empty.

>pour cup into machine
But the cup is empty.

>pour water into machine
You can't see any such thing.

>put cup in watertank
But the cup is empty.

>empty cup in watertank
But the cup is empty.

>pour cup in watertank
But the cup is empty.

>pour water in watertank
You can't see any such thing.

>put cup into sink
You put the cup into the sink.

>turn on tap
The water starts to flow into the cup. It is full now.

>turn off tap
The water stops flowing.

>get cup
Taken.

>x watertank
The watertank is empty.

>put cup in coffee machine
You put the cup with water into the coffee machine.

>undo
Kitchen
[Previous turn undone.]

>empty cup into coffee machine
You pour the water from the cup into the watertank.

>undo
Kitchen
[Previous turn undone.]

>pour cup into coffee machine
You pour the water from the cup into the watertank.

>undo
Kitchen
[Previous turn undone.]

>pour water in machine
You pour the water from the cup into the watertank.

>undo
Kitchen
[Previous turn undone.]

>put cup into watertank
You pour the water from the cup into the watertank.

>undo
Kitchen
[Previous turn undone.]

>empty cup in watertank
You pour the water from the cup into the watertank.

>undo
Kitchen
[Previous turn undone.]

>pour cup into watertank
You pour the water from the cup into the watertank.

>undo
Kitchen
[Previous turn undone.]

>pour water into watertank
You pour the water from the cup into the watertank.

>x watertank
There is some water in the watertank, the water level reaches up to a line labelled 1.

>put cup into sink
You put the cup into the sink.

* * *

>get cup
Taken.

>pour water into sink
You pour the content of the cup into the sink. Now the cup is empty again.

>plug machine into outlet
You plug the coffee machine into the wall outlet.

>put cup into machine
You put the cup into the coffee machine.